###############
#.........@...#
#......########
#...$..$.....X#
#######.......#
#........$.####
#...........###
#X.....X......#
###############
