###############
#.........@...#
#.......#######
#.......$....X#
#######$......#
#..........####
#...........###
#......X.$...X#
###############
