##############
#X..$........#
#####....$..X#
#####.....####
#.........####
###...@....###
##############

