###############
#.........@...#
#.......#######
#...$..$.....X#
#######.......#
#........$.####
#...........###
#X.....X......#
###############
