###############
#X...$.......X#
#####........##
#####...#######
#.......#######
######..$..####
#####......####
#...@.........#
###############
