##############
#.X..#X#.X...#
#....#.#.....#
#.$..#.#....##
#.....$..$.###
###...@....###
##############

