###############
#............X#
#...........X##
#.......#######
#....@..#######
#..........####
#..$.....$.####
#.............#
###############
